 ###################
 #oooooooo#oooooooo#
 #o##o###o#o###o##o#
 #ooooooooooooooooo#
 #o##o#o#####o#o##o#
 #oooo#ooo#ooo#oooo#
 ####o### # ###o####
 ####o#   M   #o####
#####o# ## ## #o#####
     o  #MMM#  o
#####o# ##### #o#####
 ####o#       #o####
 ####o# ##### #o####
 #oooooooo#oooooooo#
 #o##o###o#o###o##o#
 #oo#oooooHooooo#oo#
 ##o#o#o#####o#o#o##
 #oooo#ooo#ooo#oooo#
 #o######o#o######o#
 #ooooooooooooooooo#
 ###################